2 2 2 2 2 2 2 2 2 2 2 2 2 2 2 2 2 2 2 2 2 2 2 2 2 2 2 2 2 2 2 2 2 2 2 2 2 2 2 2 2 2 2 2 2 2 2 2 2 2 
2 2 2 2 2 2 2 2 2 2 2 2 2 2 2 2 2 2 2 2 2 2 2 2 2 2 2 2 2 2 2 2 2 2 2 2 2 2 2 2 2 2 2 2 2 2 2 2 2 2 
2 2 2 2 2 2 2 2 2 2 2 2 2 2 2 2 2 2 2 2 2 2 2 2 35 2 2 2 2 2 2 2 2 2 2 2 2 2 2 2 2 2 2 2 2 2 2 2 2 2 
2 2 2 2 2 2 2 2 2 2 2 2 2 2 2 2 2 2 2 2 2 2 2 2 2 2 2 2 2 2 2 2 2 2 2 2 2 2 2 2 2 2 2 2 2 2 2 2 2 2 
2 2 2 2 2 2 2 2 2 2 2 2 2 2 2 2 2 2 2 2 2 2 2 2 2 2 2 2 2 2 2 2 2 2 2 2 2 2 2 2 2 2 2 2 2 2 2 2 2 2 
2 2 2 2 2 2 2 2 2 2 2 2 2 2 2 2 2 2 2 2 2 2 2 2 2 2 2 2 2 2 2 2 2 2 2 2 2 2 2 2 2 2 2 2 2 2 2 2 2 2 
2 2 2 2 2 2 2 2 2 2 2 2 2 2 2 2 2 2 2 2 2 2 2 2 35 2 2 2 2 2 2 2 2 2 2 2 2 2 2 2 2 2 2 2 2 2 2 2 2 2 
2 2 2 2 2 2 2 2 2 2 2 2 2 2 2 2 2 2 2 2 2 2 2 2 2 2 2 2 2 2 2 2 2 2 2 2 2 2 2 2 2 2 2 2 2 2 2 2 2 2 
2 2 2 2 2 2 2 2 2 2 2 2 2 2 2 2 2 2 2 2 2 2 2 2 2 2 2 2 2 2 2 2 2 2 2 2 2 2 2 2 2 2 2 2 2 2 2 2 2 2 
2 2 2 2 2 2 2 2 2 2 2 2 2 2 2 2 2 2 2 2 2 2 2 2 2 2 2 2 2 2 2 2 2 2 2 2 2 2 2 2 2 2 2 2 2 2 2 2 2 2 
2 2 2 2 2 2 2 2 2 2 2 2 2 2 2 2 2 2 2 2 2 2 2 2 2 2 2 2 2 2 2 2 2 2 2 2 2 2 2 2 2 2 2 2 2 2 2 2 2 2 
2 2 2 2 2 2 2 2 2 2 2 2 2 2 2 2 2 2 2 2 2 2 60 61 62 2 2 2 2 2 2 2 2 2 2 2 2 2 2 2 2 2 2 2 2 2 2 2 2 2 
2 2 2 2 2 2 2 2 2 2 2 2 2 2 2 2 2 2 2 2 2 2 63 64 65 66 2 2 2 2 2 2 2 2 2 2 2 2 2 2 2 2 2 2 2 2 2 2 2 2 
2 2 2 2 2 2 2 2 2 2 2 2 2 2 2 2 2 2 2 2 2 2 67 68 69 70 2 2 2 2 2 2 2 2 2 2 2 2 2 2 2 2 2 2 2 2 2 2 2 2 
2 2 2 2 2 2 2 2 2 2 2 2 2 2 2 2 2 2 2 2 2 2 71 72 73 74 2 2 2 2 2 2 2 2 2 2 2 2 2 2 2 2 2 2 2 2 2 2 2 2 
2 2 2 2 2 2 2 2 2 2 2 2 2 2 2 2 2 2 2 2 2 2 2 2 2 2 2 2 2 2 2 2 2 2 2 2 2 2 2 2 2 2 2 2 2 2 2 2 2 2 
2 2 2 2 2 2 2 2 2 2 2 2 2 2 2 2 2 2 2 2 2 2 2 2 2 2 2 2 2 2 2 2 2 2 2 2 2 2 2 2 2 2 2 2 2 2 2 2 2 2 
2 2 2 2 2 2 2 2 2 2 2 2 2 2 2 2 2 2 2 2 2 2 2 2 2 2 2 2 2 2 2 2 2 2 2 2 2 2 2 2 2 2 2 2 2 2 2 2 2 2 
48 48 48 48 48 48 48 48 48 48 48 48 49 2 2 2 2 2 2 2 2 2 8 3 3 3 7 2 2 2 2 2 2 2 2 2 2 2 2 2 20 21 21 21 21 21 21 21 21 21 
59 59 59 59 59 59 59 59 59 59 59 59 51 2 2 2 2 2 2 2 2 2 8 3 3 3 7 2 2 2 2 2 2 2 2 2 2 2 2 2 23 19 19 19 19 19 45 19 44 45 
59 59 59 59 59 59 59 59 59 59 59 59 51 2 2 2 2 2 2 2 2 2 8 3 3 3 7 2 2 2 2 2 2 2 2 2 2 2 2 2 23 44 19 46 19 19 19 43 45 45 
59 59 59 59 59 59 59 59 59 59 59 59 51 2 2 2 2 2 2 2 2 2 8 3 3 3 7 2 2 2 2 2 2 2 2 2 2 2 2 2 23 19 19 19 19 19 19 19 19 45 
59 59 59 59 59 59 59 59 59 59 59 59 51 2 2 2 2 2 2 2 2 2 8 3 3 3 7 2 2 2 2 2 2 2 2 2 2 2 2 2 23 19 46 43 19 19 19 45 19 43 
59 59 59 59 59 59 59 59 59 59 59 59 51 2 2 2 2 2 2 2 2 2 8 3 3 3 7 2 2 2 2 2 2 2 2 2 2 2 2 2 23 19 46 46 19 46 19 19 43 19 
59 59 59 59 59 59 59 59 59 59 59 59 51 2 2 2 2 2 2 2 2 2 8 3 3 3 7 2 2 2 2 2 2 2 2 2 2 2 2 2 23 19 19 19 19 43 19 19 19 19 
59 59 59 59 59 59 59 59 59 59 59 59 51 2 2 2 2 2 2 2 2 2 8 3 3 3 7 2 2 2 2 2 2 2 2 2 2 2 2 2 23 44 19 19 19 19 19 19 19 19 
59 59 59 59 59 59 59 59 59 59 59 59 51 2 2 2 2 2 2 2 2 2 8 3 3 3 7 2 2 2 2 2 2 41 2 2 2 41 2 2 23 19 19 19 19 19 43 19 46 19 
59 59 59 59 59 59 59 59 59 59 59 59 56 48 48 10 10 10 10 10 10 10 11 3 3 3 9 10 10 10 10 10 10 10 10 10 10 10 13 2 23 19 46 19 19 19 19 19 19 19 
59 59 59 59 59 59 59 59 59 59 59 59 59 59 59 3 3 3 3 3 3 3 3 3 3 3 3 3 3 3 3 3 3 3 3 3 3 3 7 2 25 26 26 29 46 19 19 19 46 19 
59 59 59 59 59 59 59 59 59 59 59 59 59 59 59 3 3 3 3 3 3 3 3 3 3 3 3 3 3 3 3 3 3 3 3 3 3 3 7 2 2 2 2 23 46 45 46 46 19 45 
59 59 59 59 59 59 59 59 59 59 59 59 59 59 59 3 3 3 3 3 3 3 3 3 3 3 3 3 3 3 3 3 3 3 3 3 3 3 7 2 20 21 21 31 46 19 19 46 19 19 
59 59 59 59 59 59 59 59 59 59 59 59 58 53 53 5 5 5 5 5 5 5 6 3 3 3 4 5 5 5 5 5 5 5 5 5 5 5 15 2 23 43 19 45 19 19 19 46 19 19 
59 59 59 59 59 59 59 59 59 59 59 59 51 40 40 40 40 40 40 40 40 40 8 3 3 3 7 40 40 40 40 40 40 40 40 40 40 41 2 2 23 44 19 19 19 19 46 46 19 19 
59 59 59 59 59 59 59 59 59 59 59 59 51 2 2 2 2 2 2 2 2 40 8 3 3 3 7 40 2 2 2 2 2 2 2 2 2 2 2 2 23 43 19 19 19 46 46 19 19 19 
59 59 59 59 59 59 59 59 59 59 59 59 51 2 2 2 2 2 2 2 2 40 8 3 3 3 7 40 2 2 2 2 2 2 2 2 2 2 2 2 23 19 19 45 19 46 19 19 19 19 
59 59 59 59 59 59 59 59 59 59 59 59 51 2 2 2 2 2 2 2 2 40 8 3 3 3 7 40 2 2 2 2 2 2 2 20 21 21 21 21 31 19 45 45 19 46 19 19 19 19 
59 59 59 59 59 59 59 59 59 59 59 59 51 2 2 2 2 2 2 2 2 40 8 3 3 3 7 40 2 2 2 2 2 2 2 23 19 19 19 46 46 46 46 45 46 46 46 46 45 46 
59 59 59 59 59 59 59 59 59 59 59 59 51 2 2 2 2 2 2 2 2 40 8 3 3 3 7 40 2 2 2 2 2 2 2 23 44 44 19 19 19 45 19 19 19 19 19 19 46 19 
59 59 59 59 59 59 59 59 59 59 59 59 51 2 2 2 16 38 16 16 38 41 41 3 3 3 41 41 38 16 16 16 16 2 2 23 43 44 19 19 19 45 19 19 19 19 19 46 44 19 
59 59 59 59 59 59 59 59 59 59 59 59 51 2 2 2 16 16 16 16 16 16 8 3 3 3 7 16 38 16 16 16 16 2 2 23 19 19 19 46 46 46 19 19 19 19 19 46 19 19 
59 59 59 59 59 59 59 59 59 59 59 59 51 2 2 2 38 16 2 2 2 2 14 5 5 5 15 2 2 2 2 16 16 2 2 23 19 45 19 46 19 19 19 19 19 44 19 19 19 45 
59 59 59 59 59 59 59 59 59 59 59 59 51 2 2 2 16 16 2 2 2 2 2 2 2 2 2 2 2 2 2 16 38 2 2 23 19 45 19 46 45 19 19 19 19 19 44 19 19 45 
59 59 59 59 59 59 59 59 59 59 59 59 51 2 2 2 16 16 2 2 2 2 2 2 33 2 2 2 2 2 39 16 16 2 2 23 19 19 19 46 45 45 28 26 29 19 19 19 45 19 
59 59 59 59 59 59 59 59 59 59 59 59 51 2 2 2 38 16 2 2 2 2 2 2 2 2 2 2 2 2 39 16 16 2 2 23 19 19 19 19 45 45 24 2 23 19 19 19 19 44 
59 59 59 59 59 59 59 59 59 59 59 59 51 2 2 2 16 16 39 2 2 2 2 2 2 2 2 2 2 2 39 38 16 2 2 23 19 19 19 19 19 19 30 21 31 19 19 46 44 19 
59 59 59 59 59 59 59 59 59 59 59 59 51 2 2 2 16 38 39 2 2 2 2 2 2 2 2 2 2 2 39 16 16 2 2 23 19 19 46 19 19 19 19 19 19 19 19 19 46 19 
59 59 59 59 59 59 59 59 59 59 59 59 51 2 2 2 38 16 39 41 20 21 21 21 21 21 21 21 22 39 39 16 16 2 2 23 19 19 19 19 19 46 19 46 19 19 19 46 19 45 
59 59 59 59 59 59 59 59 59 59 59 59 51 2 2 2 16 16 39 39 23 45 19 19 19 19 19 45 24 39 39 16 38 2 2 25 26 26 26 26 26 26 26 26 26 26 26 26 26 26 
59 59 59 59 59 59 59 59 59 59 59 59 51 2 2 2 38 38 39 39 23 45 46 19 19 19 46 19 24 41 39 16 16 2 2 2 2 2 2 2 2 2 2 2 2 2 2 2 2 2 
59 59 59 59 59 59 59 59 59 59 59 59 51 2 2 2 16 38 16 38 23 45 19 19 19 43 19 19 24 38 38 38 16 2 2 2 2 2 2 2 2 2 2 2 2 2 2 2 2 2 
